#######################################
#.....................................#
#.....................................#
#....################.................#
#.....................................#
#.....................................#
#...............#.....................#
#..............##.....#############...#
#.............#.#.....................#
#...............#.....................#
#...............#.....................#
#..........     #         ............#
#...............#.....................#
#...............#.....................#
#...............#.....................#
#...........#########            .....#
#.....................................#
#.....................................#
#.....................................#
#...#####################.............#
#.....................................#
#.....................................#
#.....................................#
#......#####################..........#
#.....................................#
#.....................................#
#.....................................#
#.....................................#
#...####################..............#
#.....................................#
#.....................................#
#.....................................#
#............####################.....#
#.....................................#
#.....................................#
#######################################
