######################################
#....................................#
#....................................#
#....#######.........................#
#..........#......................#..#
#..........#......................#..#
#.................................#..#
#.....................#############..#
#.......#.......#.................#..#
#.......#.......#.................#..#
#...    #       #.................#..#
#.......#.......#.................#..#
#.......#.......#.................#..#
#.......#########.................#..#
#...............#.................#..#
#...............#             ....#..#
#...............#....................#
#...............#....................#
#...............#....................#
#...............#....................#
#...#......................#.........#
#....#.....................#.........#
#.....#....#...............#.........#
#......#..#................#.........#
#.......#..................#.........#
#.......#..................#.........#
#...........................   ......#
#....................................#
#    ###################..... .......#
#... #.................. .... .......#
#... #.................. ..... ......#
#.. .#......................... .....#
#............................ .......#
#..........###################.......#
#....................................#
#....................................#
######################################
