######################################
#....................................#
#....................................#
#....#######....############.........#
#..............................#..   #
#..............................#.   .#
#..............................#.   .#
#.....................    ######   ..#
#..............................#.   .#
#....      ######      ........#.   .#
#....#..........#..............#.....#
#....#..........#..............#.....#
#....#..........#..............#.....#
#....#.....######..............#.....#
#....#..........#..............#.....#
#....#..........#             .#.....#
#....#..........#....................#
#..........######....................#
#................................. ..#
#................................. s..#
#....................................#
#....................................#
#........###############.............#
#....................................#
#....................................#
#....................................#
#....................................#
#....................................#
########################.............#
#...#................................#
#...#................................#
#...#................................#
#............................#.......#
#..........###################.......#
#..........#.........................#
#..........#.........................#
#..........#.........................#
#....................................#
######################################
