######################################
#....................................#
#....................................#
#....#######....############.........#
#..............................#..   #
#..............................#.   .#
#..###########.................#.   .#
#.....................    ######   ..#
#..............................#.   .#
#....           #########......#.   .#
#....#..........#..............#.....#
#....#..........#..............#.....#
#....#..........#..............#.....#
#....#    ......#..............#.....#
#....#..........#..............#.....#
#....#..........#########     .#.....#
#....#..................#......... ..#
#.......................#.......... .#
#.......................#.......... .#
#.......................#......... ..#
#.......................#............#
#.......................#............#
#........      ##########............#
#.............................#......#
#.............................#......#
#.............................#......#
#.............................#......#
#.............................#......#
########################.............#
#...#................................#
#...#................................#
#...#................................#
#............................#.......#
#..........###################.......#
#..........#.........................#
#..........#.........................#
#..........#.........................#
#....................................#
######################################
